{
    "grid": [
      [0, 0, 0, 1, 0, 0, 0, 0, 0, 0, 0, 0, 0, 0, 0],
      [1, 1, 0, 1, 0, 0, 1, 1, 1, 0, 1, 0, 1, 1, 1],
      [0, 0, 0, 0, 0, 1, 0, 0, 0, 1, 0, 0, 0, 0, 1],
      [0, 1, 1, 1, 0, 1, 0, 1, 1, 1, 1, 1, 0, 0, 0],
      [0, 0, 0, 1, 0, 0, 0, 0, 0, 0, 0, 1, 0, 1, 0],
      [1, 0, 0, 1, 1, 1, 1, 0, 1, 1, 0, 1, 0, 1, 0],
      [0, 0, 0, 0, 0, 0, 1, 0, 1, 0, 0, 0, 0, 1, 0],
      [1, 1, 1, 1, 0, 0, 1, 0, 1, 0, 1, 1, 0, 1, 1],
      [0, 0, 0, 0, 0, 0, 0, 0, 1, 0, 0, 0, 0, 0, 0],
      [0, 1, 1, 1, 1, 1, 1, 0, 1, 1, 1, 1, 1, 1, 0],
      [0, 0, 0, 0, 0, 0, 1, 0, 0, 0, 0, 0, 0, 0, 0],
      [1, 1, 1, 0, 1, 1, 1, 0, 1, 1, 1, 1, 1, 1, 0],
      [0, 0, 0, 0, 0, 0, 0, 0, 0, 0, 1, 0, 0, 0, 0],
      [0, 0, 0, 0, 0, 0, 0, 0, 0, 0, 0, 0, 1, 0, 1],
      [0, 1, 0, 1, 0, 1, 1, 0, 1, 0, 0, 1, 1, 0, 1]
    ],
    "start": [0, 0],
    "end": [12, 14]
  }
